0 2 1 1 2 4 2 1 2 2 4 2 2 4 3 81
10 11 12 11 12 13 11 12 13 13 11 12 13 14 14 15
10 21 22 85 7 8 16 17 16 17 18 19 8 9 14 35
30 31 77 7 8 9 95 27 26 27 28 29 95 19 24 35
20 11 6 7 8 9 23 16 17 81 28 29 28 29 34 25
20 21 6 7 8 9 23 16 17 18 19 7 8 9 34 25
20 31 77 6 7 8 9 26 27 28 29 17 18 19 81 25
20 11 6 7 8 9 19 16 81 17 26 27 28 29 14 25
30 11 16 81 18 19 95 26 26 27 16 17 18 19 14 81
30 21 26 27 28 29 16 17 18 19 26 27 28 29 24 15
30 31 32 33 34 34 32 33 32 33 33 34 33 34 34 15
40 41 41 41 41 42 42 43 43 43 43 44 44 44 44 45

