0 1 2 3 1 2 3 1 2 3 1 1 2 3 4 5
10 6 7 8 9 6 7 8 9 6 7 6 7 8 9 15
20 6 7 8 9 16 17 18 19 16 17 16 17 18 19 25
0 6 7 8 9 26 27 28 29 26 27 26 27 28 29 35
10 6 7 8 9 6 7 8 9 16 17 6 7 8 9 5
20 6 7 8 9 16 17 18 19 26 27 16 17 18 19 15
30 6 7 8 9 26 27 28 29 19 6 7 8 9 29 25
0 6 7 8 9 26 27 28 29 29 16 17 18 19 19 5
10 6 7 6 6 6 6 6 26 27 26 27 28 29 29 15
20 16 17 16 16 16 16 16 16 16 26 27 28 29 19 25
30 26 27 26 26 26 26 26 26 26 26 26 27 28 29 35
40 41 42 43 41 42 41 42 41 42 43 41 42 43 44 45
